. . . . . . . F O R C E F I E L D M
. . . . . . . . . . . . . . . . . U
. . . . . . . . . . . . . . . . . T
. . . N I G H T L O C K B E R R Y T
D I S T R I C T T W E L V E . . . A
. . . . . . J A B B E R J A Y . . T
. . . . . . . . . . . . P . . . . I
. . . . . . . . . . . . . A . . . O
M O C K I N G J A Y . . . . N . . N
. . . . . . H U N G E R G A M E S .
. . . . . . . . A V O X . . . . M .
B O W A N D A R R O W . . . . . . .
