. . P . . P . . . . . .
. . H . . R . . . . . .
E . O . . O . . . D . .
V . E . . P . . . A . .
I . N . T H E S T R A L
L . I . . E . . . K . .
. . X . . C . . . N . .
. . . . . Y . . . E . .
. . . . . . . . . S . .
. . . . . . . . . S . .